11 10
11111122223
10200020003
10200000003
10200200003
10000200003
11000200003
10002221003
10001000003
10001000003
11111111111